Limited Edition Alpha|limitedalpha|
Limited Edition Beta|limitedbeta|
Unlimited Edition|unlimitededition|
Revised Edition|revisededition|
Fourth Edition|fourthedition|
Fifth Edition|fifthedition|
Classic Sixth Edition|sixthedition|
Seventh Edition|seventhedition|
Eighth Edition|eighthedition|
Ninth Edition|ninthedition|
Tenth Edition|tenth|
Magic 2010|magic2010|
Magic 2011|magic2011|
Magic 2012|magic2012|
Magic 2013|magic2013|
Magic 2014|magic2014|
Planechase|planechase|
Planechase 2012 Edition|planechase2012|
Duel Decks: Heroes vs. Monsters|heroesvsmonsters|
Duel Decks: Elspeth vs. Tezzeret|elspethvstezzeret|
Arabian Nights|arabiannights|
Antiquities|antiquities|
Legends|legends|
The Dark|thedark|
Fallen Empires|fallenempires|
Homelands|homelands|
Ice Age|iceage|
Alliances|alliances|
Coldsnap|coldsnap|
Mirage|mirage|
Visions|visions|
Weatherlight|weatherlight|
Tempest|tempest|
Stronghold|stronghold|
Exodus|exodus|
Urza's Saga|urzassaga|
Urza's Legacy|urzaslegacy|
Urza's Destiny|urzasdestiny|
Mercadian Masques|mercadianmasques|
Nemesis|nemesis|
Prophecy|prophecy|
Invasion|invasion|
Planeshift|planeshift|
Apocalypse|apocalypse|
Odyssey|odyssey|
Torment|torment|
Judgment|judgment|
Onslaught|onslaught|
Legions|legions|
Scourge|scourge|
Mirrodin|mirrodin|
Darksteel|darksteel|
Fifth Dawn|fifthdawn|
Champions of Kamigawa|championsofkamigawa|
Betrayers of Kamigawa|betrayersofkamigawa|
Saviors of Kamigawa|saviorsofkamigawa|
Ravnica: City of Guilds|ravnika|
Guildpact|guildpact|
Dissension|dissension|
Time Spiral|timespiral|
Time Spiral "Timeshifted"|timeshifted|
Planar Chaos|planarchaos|
Future Sight|futuresight|
Lorwyn|lorwyn|
Morningtide|morningtide|
Shadowmoor|shadowmoor|
Eventide|eventide|
Shards of Alara|shardsofalara|
Conflux|conflux|
Alara Reborn|alarareborn|
Zendikar|zendikar|
Worldwake|worldwake|
Return to Ravnica|returntoravnica|
Rise of the Eldrazi|riseoftheeldrazi|
Scars of Mirrodin|scarsofmirrodin|
Mirrodin Besieged|mirrodinbesieged|
New Phyrexia|newphyrexia|
Innistrad|innistrad|
Dark Ascension|darkascension|
Avacyn Restored|avacynrestored|
Gatecrash|gatecrash|
Magic: The Gathering-Commander|commander|
Commander 2013 Edition|commander2013|
Dragon's Maze|dragonsmaze|
Modern Masters|modernmasters|
Theros|theros|
Born of the Gods|bornofthegods|
Portal Three Kingdoms|portalthreekingdoms